.. .. .. .. .. .. .. .. .. .. .. .. .. .. .. .. .. .. .. ..
.. .. .. .. .. .. .. .. .. .. .. .. .. .. #. .. .. .. .. ..
.. .. .. .. .. .. .. a. .. .. .. .. .. .. #. .. .. .. .. ..
.. .. .. .. b. .. .. .. .. .. .. .. .. .. #. .. .. .. .. ..
.. .. .. .. .. .. .. .. .. .. .. .. .. .. #. .. .. .. .. ..
.. .. .. .. .. .. .. .. .. .. .. .. .. .. #. .. .. .. .. ..
.. .. .. #. #. .. #. #. #. #. #. #. #. #. #. .. #. #. #. #.
.. .. .. #. #. .. #. #. #. #. #. #. #. #. #. .. #. #. .. ..
.. .. .. #. #. .. c. .. d. .. e. .. f. .. g. .. .. .. .. ..
.. .. .. #. #. .. #. #. #. #. #. #. #. #. #. .. #. #. #. ..
.. .. .. #. #. .. #. #. #. #. #. #. #. #. #. .. #. #. #. .e
.. .. .. .. .. .. #. #. #. #. #. #. #. #. #. .. #. #. #. #.
.. .. .. h. .. .. #. #. #. #. #. #. #. #. #. .. #. #. #. #.
.. .. .. .. .. .. .. .. .. .. P. .. .. .. .. .. #. #. #. #.
