.. .| .| .| .| .| .| .| .| .| .|
.. .| .| .| .| .| .| .| .| .| .|
.. .. .. .. .. .. .. .. .. .. ..
.. .. a. a. .. .. .. .. .. .. ..
.. .. a. a. .. .. .. .. .. .. ..
.. .. .. .. .. .a .a .. .. .. ..
.. .. .. .. .. .a ba b. b. b. b.
.. .. .. .. .. .. .. .. .. .. b.
.. .. P. .. .. .. b. b. b. b. b.
.. .. .. .. .. .. b. .. .. .. ..
.. .. .. .. .. .. b. b. b. b. b.
