.. .. .. .. .. .. .. .. ..
a. .. .. .. .. .. b. .. ..
a. .. .. .. .. .. .. .. ..
a. a. .. .. .. .. .. .. ..
.. .. .. .. .. .. .. #. #.
.. .. .. P. P. P. .. .. .b
.. .. .. .. P. .. .. #. #.
.a .. .. .. .. .. .. .. ..
.a .. .. .. .. .. .. .. ..
.a .a .. .. .. .. .. .. ..
