.. .. .. .. .. .. .. .. .. .. .. .b
.. .. .. .. .. .. .. .. .. .. .. .b
.. #. #. #. #. #. #. #. .. #. #. #.
.. #. #. #. #. #. #. #. .. #. #. #.
.. P. #. #. #. #. #. #. .. #. #. #.
.. P. #. #. #. #. #. #. .. #. #. #.
.. b. .. .. .. .. .. .. .. #. #. #.
.. b. .. .. .. .. .. .. .. #. #. #.
.. .. #. #. #. #. #. .. .. #. #. #.
.. .. #. #. #. #. #. .. .. #. #. #.
.. #. #. #. #. #. #. #. .. #. #. #.
.. #. #. #. #. #. #. #. .. #. #. #.
