.. .. .. .. .. .. .. .. .. .. .. .. ..
.. .. .. .. .. .. .. .. .. .. .. .. ..
.. .. .. b. b. .. .. .. .. .. .. .b .b
.. P. .. b. b. .. aa .. .. .. .. .b .b
.. .. .. b. b. .. .. .. .. .. .. .b .b
.. .. .. b. b. .. .. .. .. .. .. .b .b
.. .. .. b. b. .. .. .. .. .. .. .b .b
.. .. .. .. .. .. .. .. .. .. .. .. ..
