.. .. .. .. .. #. .a #. .. .. .. ..
.. P. .. .. .. #. .. #. .. .. .. ..
.. .. .. .. .. #. .. #. .. .. .. ..
.. .. .. .. .. #. .. #. .. .. .. ..
.. .. #. #. #. #. .. #. #. #. #. #.
.. .. .. .. .. .. b. .. .. .. .. ..
.. .. #. #. #. #. .. #. #. #. #. #.
.. .. .. .. .. #. a. #. .. .. .. ..
.. .. .. .. .. #. .. #. .. .. .. ..
.. .. .. .. c. .. .. .. .. .. .. ..
