.. .. .. .. .. .. .b .. .. .. .. ..
.. .. .. .. .. .. .b .b .. .. .. ..
.. .. .. #. #. .. .. .. .. .. .. ..
.. .. .. #. #. .. #. #. .. .. #. #.
.. .. P. P. .. .. #. #. .. .. #. #.
.. .. .. .. .. .. .. .. .. .. .. ..
.. .. .. #. #. .. .. .. .. .. .. ..
.. .. .. #. #. b. .. .. .. .. .. ..
.. .. .. .. .. b. b. .. #. #. .. ..
.. .. .. .. .. .. .. .. #. #. .. ..
.. .. .. .. .. .. .. .. .. .. .. ..
.. .. .. .. .. .. .. .. .. .. .. ..
