.. .. .. .. .. .. .. .. .. .. .. ..
.. .. .. .. .. .. .. .. .. .. .. ..
.. .. .. .. .. .. .. .. .. .. .. ..
.. a. .. .. .. .. c. c. c. c. .. ..
.. a. .. .. .. .c .c .c .c c. .. ..
.. .. .. .. .. .d .b .b .c c. .. ..
.. .. .. .. .. dd .b .b .c .. .. ..
.. .. .. .. .. d. b. b. .. .. .. ..
.. .. .. .. P. P. b. b. .. .. .. ..
.. .. .. .. P. P. .. .. .. .. .. ..
.. .. .. .. .. .. .. .. .. .. .. ..
.. .. .. .. .. .. .. .. .. .. .. ..
