.. .. .. .. .. .. .. ..
.b .. .. .. .. .. .. ..
.. #. #. #. #. .. .. ..
.. #. .. .. .. .. .. ..
.. #. .. .. #. #. .. ..
.. #. .. P. .. #. .. ..
.. #. .. .. .. #. .. ..
.. #. .. a. .. #. b. ..
.. #. .. .. .. #. .. ..
.. #. #. #. #. #. .. ..
.. .. .. .. .. .. .. ..
.. .. .. .. .. .. .. ..
