.. .. .. #.
.. #. P. #.
.. .. b. #.
.. #. b. #.
.. a. b. .a
.. #. b. #.
.. .. .. #.
