.. .. .. .. P. .. .. .. .. .. .. ..
.. .. .. .. P. .. .. .. .. .. .. ..
.. .. .. .. P. .. .. .. .. .. .. ..
.. b. b. .. .. c. c. c. c. c. .. ..
.. b. b. .. .. c. .. .. .. .. .. ..
.. .. .. .. .. c. .. .. .. .. .. ..
.. .. .. .. .. c. .. .. .. .. .. ..
.. .. .. .. .. c. .. .c .c .c .c .c
.. .. .. .. d. .. .. .c .. .. .. ..
.. .. .. .. .. .. .. .c .. .. .. ..
.. .. .. .. .. .. .. .c .. .. .b .b
.. .. .. .. .. .. .. .c .. .. .b .b
