.. .. .. .. .. .. .. .. .. .. ..
.. e. e. .. .. b. .. .. .. .. ..
.. .. .. .. .. .. .. .. h. .. ..
.. .. .. .. .. a. .. .. .a .. ..
f. .. .. .. .. .. .. .. .. .. ..
.. .. P. .. g. .. .. c. .. .. ..
.. .. .. .. .. .. .. .. d. d. ..
