.. #. .. #. #. ..
P. a. b. .a #. ..
.. .. c. .. .. ..
.. .. .. .. .. ..
.. .. .. .. .. ..
.. .. .. .. .. ..
