.. .. .. .. .. .. .. .. .. .. .. ..
.. .. .. .. .. .. .. .. .. .. .. ..
.. .. .. .. .. .. .. .. .c .c .c .c
.. .. b. b. .. a. .. .. .. .. .. ..
.. .. .. b. .. .. .. .. .. .. .b .b
.. .. .. .. .. .. .. .. .. .. .. .b
.. .. .. .. .. .. .. .. .. .. .. ..
.. .. .. .. .. .. #. .. c. c. c. c.
.. .. .. .. .. .. #. .. .. .. .. ..
.. .. .. .. .. .. #. .. .. .. P. ..
.. .. .. .. .. .. #. .. .. .. .. ..
.. .. .. .. .. .. #. .. .. .. .. ..
