.. .. .. .. .. .. .. .. .. .. .. .a
.. P. .. .. .. .. .. .. a. .. #. #.
.. P. P. .. .. .. .. b. .. .. .. ..
.. .. .. .. .. .. c. .. .. .. .. ..
.. .. .. .. .. .. .. .. .. .. .. ..
.. .. .. .. .. .. .. .. .. .. .. ..
