.. .. .. .. .. .. .. .. .. ..
.. a. a. a. .. .. .. .. .. ..
a. a. a. .. .. .. .. .. .. ..
.. .. .. .. .. .. .. .. .. ..
.. .. .. .. .. .. #. .. .. ..
.. .. .. .a .a .a #. .. P. ..
.. .. .a .a ba .. #. .. .. ..
.. .. .. .. .. .. #. .. .| .|
.. .. #. #. #. #. #. .. .| .|
