.. .. .. .. .. .. .. .. .. .. .. .. ..
.. .. .. .. .. .. .. .. .. .. .. .. ..
.. .. .. .. .. .. .. .. b. .b .. .. ..
.. .. .. .. .. .. .. .. .. .. .. .. ..
.| .| .| .| .| .| .| .| .| .| .| .| .|
.. .. .. .. .. .. aa .. .. .. .. .. ..
.. .. .. .. .. .. aa .. .. .. .. .. ..
.. .. .. .. .. .. aa .. .. .. .. .. ..
.. .. .. .. P. P. aa .. .. .. .. .. ..
.. .. .. P. P. aa aa .. .. .. .. .. ..
.. .. .. .. .. .. .. .. .. .. .. .. ..
.. .. .. .. .. .. .. .. .. .. .. .. ..
