.. .. .. .. .. .. .. .. .. .. .. ..
.. .. .. .. .. .. .. .. .. .. .. ..
.. .. .. .. .. P. P. .. .. .. .. ..
.. .. .. .. .. b. .. .. .. .. .. ..
.. .. #. #. #. .. #. #. #. .. .. ..
.. .. #. #. #. .. #. #. #. .. .. ..
.. .. #. #. #. .. #. #. #. .. .. ..
.. .. .. .. .. .b .. .. .. .. .. ..
.. .. #. #. #. .. #. #. #. .. .. ..
.. .. #. #. #. .. #. #. #. .. .. ..
.. .. #. #. #. .. #. #. #. .. .. ..
.. .. .. .. .. .. .. .. .. .. .. ..
