.. .. .b .b .. .. .. .. .. .. .. ..
.. .. .b .b .. .. .. .. .. .. .. ..
.. .. .. .. .. .. .. .. .. .. .. ..
#. #. #. #. #. #. #. #. #. .. .. ..
.. .. .. .. .. .. .. .. .. .. .. ..
.. .. .. .. .. .. .. .. .. .. .. ..
.. .. .. .. .. .. .. .. .. a. a. ..
.. .. .. .. .. b. b. .. .. .. .. ..
.. .. P. .. .. b. b. .. .. .. .. ..
.. .. .. .. .. .. .. .. .. .. .. ..
.. .. .. .. .. .. .. .. .. .. .. ..
.. .. .. .. .. .. .. .. .. .. .. ..
