.. .. .. .. .. .. .. .. .. .. .. ..
.. .. .. .. .. .. .. .. .. .. .. ..
.. .. .. .. .. .. .. .. #. #. #. #.
.. .. .. .. .. .. .. .. .. .a .. .a
.. P. P. P. .. .. .. .. .. .a .a .a
.. P. P. P. .. .. .. .. #. #. #. #.
.. P. P. P. .. .. b. b. b. .. .. ..
.. .. .. a. .. a. .. b. .. .. .. ..
.. .. .. a. a. a. .. .. .. .. .. ..
.. .. .. .. .. .. .. .. .. .. .. ..
.. .. .. .. .. .. .. .. .. .. .. ..
.. .. .. .. .. .. .. .. .. .. .. ..
