.. .. .. .. .. .. .. .. .. .. .. ..
.. .. P. P. c. c. .. .. .. .. .. ..
.. .. .. .. .. c. .. .. .. .. .. ..
.. .. b. .. .. c. .. .. .. .. .. ..
.. .. b. .. .. c. .. .. .. .. .. ..
.. .. b. .. .. .. #. #. #. #. .. ..
.. .. b. b. .. .. .. .. .. .. .. ..
.. .. .. .. .. .. .. .. .c .c .. ..
.. .. .. .. .. .. .. .. .b .c .. ..
.. .. a. a. .. .. .. .. .b .c .. ..
.. .. .. .. .. .. .. .. .b .c .. ..
.. .. .. .. .. .. .. .. .b .b .. ..
