.. .. .. .. #. .a #. .. .. ..
.. .. .. .. .. a. .. .. .. ..
.. .. .. .. .. .. .. .. .. ..
.. .. .. .. .. bb .. .. .. ..
.. .. .. .. .. bb .. .. .. ..
.. .. .. .. .. bb .. .. .. ..
.. .. .. .. .. bb .. .. .. ..
.. .. .. .. .. bb .. .. .. ..
.. .. .. bb bb bb .. .. .. ..
.. .. .. .. .. P. P. P. .. ..
.. .. .. .. .. P. P. P. .. ..
.. .. .. .. .. .. .. .. .. ..
