.. .. .. .. .. .. .. .. .. .. .. ..
.. .. .. .. .. .. .. .. .. .. .. ..
.. .. .. b. .. #. .. .. .. .. .a ..
.. .. .. .. .. #. .. .. .. .. .. ..
.. .. .. .. .. #. .. .. .. #. #. #.
.. P. P. P. a. .. .. .. .. #. #. #.
.. P. .. .. .. .. .. .. .. #. #. #.
.. P. P. P. .. .. .. .. .. #. #. #.
.. .. .. .. .. .. .. .. .. #. #. #.
