.. b. b. .. c. c. .. .. .. .. a. .a
.. .. .. .. .. .. #. #. #. #. #. #.
.. .. .. .. .. .. .. .. .. .. .. ..
.. .. .. .. .. .. .. .. .. .. .. ..
.. .. .. .. d. .. .. .. .. .. .. ..
.. .. .. .. d. d. d. d. .. .. .. ..
.. .. P. P. .. .. .. d. .. .. .. ..
.. .. P. .. .. .. d. d. .. .. .. ..
.. .. .. .. .. .. .. .. .. .. .. ..
.. .. .. .. .. .. .. .. .. .. .. ..
