.. .. .. .. .. .. .. .. .. .. .. ..
.. P. P. P. .. .. .. .. .c .. .. ..
.. .. .. .. b. .. .. #. .c .. .. ..
.. .. .. .. .. .. .b #. .c .. .. ..
.. .. .. .. a. .. .. #. .c .. .. ..
.. .. .. .. .. .. .. .. .c .. .. ..
.. .. .. c. .. .. .. .. .. .. .. ..
.. .. .. c. .. d. .. .. .. .. .. ..
.. .. .. c. .. .. .. .. .. .. .. ..
.. .. .. c. .. .. .. .. .. .. .. ..
.. .. .. c. .. .. .. .. .. .. .. ..
.. .. .. .. .. .. .. .. .. .. .. ..
