.. h. h. h. .. .. .. a. .a
.. .. .. #. d. c. b. #. #.
.. .. .. #. e. f. g. #. ..
P. .. .. .. .. .. .. .. ..
P. P. .. .. .. .. .. .. ..
.. .. .. .. .. .. .. .. ..
