.. .. .. .. .. .. .. .. .. #. .. ..
.. .. .b .. .. #. .. .. .. .. .. ..
.. .. .. .. #. .. .. .. .. #. .. ..
.. .. #. .. .. .. #. .. #. .. .. ..
.. #. .. .. c. .. .. .. .. .. #. ..
.. a. .. .. .. #. .. #. .. .. .. ..
.. .. .. #. .. .. .. .. .. #. .. ..
.. #. .. .. .. #. b. .. .. .. .. P.
.. .. .. #. .. .. .. .. #. .. #. ..
.. .. #. .. #. .. #. .. .. .. .. ..
.. .. .. .. .. .. .. #. .. #. .. ..
.. .. .. .. .. .. .. .. .. .. .. ..
