.. .. .. .. .. .. .. .. ..
.. .. .b .. .. .. .. .. ..
.. .. c. .. .. #. .. .. ..
.. .. .. .. #. .. .. .. ..
.. .. #. .. .. b. .. .. ..
.. #. .. .. #. .. .. .. ..
.. .. a. .. .. #. .. .. ..
.. .. .. #. .. P. .. .. ..
.. .. .. .. .. .. .. .. ..
.. .. .. .. .. .. .. .. ..
