.. .. .. .. .. .. .. .. .. .. .. ..
.. .. .. .. .. .. .. P. .. .. .. ..
.. .. .. .. .. b. .. .. .. .. .. ..
.. .. .. .. .. .. .. .. .. .. .. ..
.. .. .. .. .. .. .. .. .. .. .. ..
#. #. #. #. #. #. #. #. #. .. #. ..
.b .. .. .. .. .. .. .. .. .. .. ..
