.. b. b. b. b. .. .. a. .a
.. .. .. .. #. d. c. #. #.
.. .. .. .. #. d. e. #. ..
.. P. .. .. .. .. .. .. ..
.. P. P. .. .. .. .. .. ..
.. .. .. .. .. .. .. .. ..
