.. .. P. .. .. .. .. .. .. .. .. ..
.. P. P. P. .. .. .. .. .. .. .b ..
.. .. P. .. .. .. .. .. c. .. .b .b
.. .. .. b. .. .. .. .. c. .. .b ..
.. .. .. b. b. .. .. .. c. .. .. ..
.. .. .. b. .. .. .. .. c. .. .. ..
.. .. .. .. .. .. .. .. .. .. .. ..
.. .. .. .. #. #. #. #. .. .. .. ..
.. .. .. .. .. .c .. .. .. .. .. ..
.. .. .. .. .. .c .. .. .. a. .. ..
.. .. .. .. .. .c .. .. .. .. .. ..
.. .. .. .. .. .c .. .. .. .. .. ..
