.. P. .. .. .. .. .. .. .. .. .. ..
.. P. P. .. .. .. .. .. .. .. .. ..
.. P. .. .. .. .. .. .. .. .. .. ..
.. .. b. .. .. .. .. c. c. c. .. ..
.. .. .. .. .. .. .. .. .. .. .. ..
.. .. .. .. d. .. a. .. .. .. .. ..
.. .. .. .. #. #. #. .. .. .. .. ..
.. .. .. .. .. .b .. .. .. .. .. ..
.. .. .. .. .c .c .c .. .. .. .. ..
.. .. .. .. .. .. .. .. .. .. .. ..
.. .. .. .. .. .. .. .. .. .. .. ..
.. .. .. .. .. .. .. .. .. .. .. ..
