.. .. .. .. .. .. .. f.
a. a. a. .. .. .. f. f.
.. a. .. .. .. .. .. .|
.a .a .a .. P. P. .. .|
.. .a d. .. .. .. .. #.
.. .. .. .. .. .. b. b.
.. .. .. .. .. .. .b .b
.. c. #. .. .. e. .. ..
.c .. .. .. .. .. .. ..
