.. .. .. .. .. .. .. .. .. .. ..
.. .. .. .. .. .. .. .. .. .. ..
.. a. a. .. .. b. .. .. .. .. ..
.. .. .. .. .. .. .. .. c. .. ..
.. .. .. .. .. e. .. .a .a .. ..
f. .. .. .. .. .. .. .. .. .. ..
.. .. P. .. g. .. .. .. d. d. ..
.. .. P. P. P. .. .. .. d. d. ..
