.. .. .. .. .. .. .. .. .. .. .. .a
.. .. .. .. .. .. .. .. .. .. .. #.
.. .. P. .. .. .. .. .. .. .. .. ..
.. .. P. P. .. b. .. a. .. .. .. ..
.. .. .. .. .. .. .. .. .. .. .. ..
.. .. .. .. .. .. .. .. .. .. .. ..
