.. #. .. #. #. ..
P. a. b. .a #. ..
.. .. .. .. .. ..
.. .. .. .. .. ..
.. .. .. .. .. ..
.. .. .. .. .. ..
