#. .a .. .. #.
#. .. .. .. #.
#. .. a. .. #.
#. .. .. #. #.
#. .. c. .. #.
#. #. .. .. #.
#. .. b. .. #.
#. .. P. #. #.
