.. P. .. .. .. .. .. .. .. .. .. ..
P. P. P. .. .. .. .. .. .. .. .. ..
.. P. .. .. .. .. .. .. .. .. .. ..
.. .. .. b. .. .. .. .. c. .. .. ..
.. .. .. b. .. a. a. .. c. .. .. ..
.. .. .. b. .. a. a. .. .b .. .. ..
.. .. .. b. .. a. a. .. .b .. .. ..
.. .. .. .c .. a. a. .. .b .. .. ..
.. .. .. .c .. .. .. .. .b .. .. ..
.. .. .. .. .. .. .. .. .. .. .. ..
.. .. .. .. .. .. .. .. .. .. .. ..
.. .. .. .. .. .. .. .. .. .. .. ..
