.. #. .. #. #. #.
.. a. b. .a #. #.
P. #. .. .. #. #.
.. #. #. .. #. #.
.. #. .. c. .. ..
.. #. #. .. #. ..
.. .. .. .. .. ..
