.. .. .. .. .. .. .. .. .. ..
.. .. .. .. .. .. .. .. .. ..
.. .. .. .. .. .. .. .. .. ..
.. .. .. #. #. #. #. #. .. ..
.. .. .. #. #. #. #. #. .. ..
.. .. a. .. .. .. b. .. .. ..
.. .. .. .. .. .. .. .. .. ..
.. .. .. #. #. #. #. #. .. ..
P. P. .. #. #. #. #. #. .. ..
P. P. .. #. #. #. #. #. .. .a
