.. .. .. .. .. .. .. .b
.. a. a. .. .. .. .. .b
.. a. .. .. .. .. .. ..
.. .. .. .. P. c. .. b.
.. .. .a .a .. .. .. b.
.. .. .a .. .. .. .. ..
.. .. .. .. .. .. .. ..
.. .. .. .. .. .. .. ..
.. .. .. .. .. .. .. .c
