.. .. .. .. .. .. .. .. .. .. ..
.. .. .. .. .. .. .. .. .. .. ..
.. .. b. b. .. .. .. .. .. .. ..
.. .. .. .. .. .. #. #. #. #. #.
.. .. .. .. .. .. .. .. .. a. .a
.. .. .. .. .. .. #. #. #. #. #.
.. .. .. .. .. .. .. .. .. .. ..
.. .. .. .. .. .. P. .. .. .. ..
.. .. c. c. .. .. P. P. .. .. ..
.. .. .. .. .. .. .. .. .. .. ..
