.. .. .. .. .. .. .. .. .. .. .. ..
.. .. .. .. .. .. .. .. .. .. .. ..
.. .. .. .. .. .. .. .. .. .. .. ..
.. .. .. .. .. .. .. .. .. .. .. ..
.. .. .. .. .. .. .. .. .. .. .. ..
.. .. b. .. .. .c .b .. .. c. .. ..
.. .. b. b. .c .c .b .b c. c. .. ..
.. .. b. .. .. .c .b .. .. c. .. ..
.. .. .. .. .. .. a. .. .. .. .. ..
.. .. .. .. .. .. a. .. .. .. .. ..
.. .. .. .. P. P. a. .. .. .. .. ..
.. .. .. .. P. P. a. .. .. .. .. ..
.. .. .. .. .. .. a. .. .. .. .. ..
