.. .. .. d. .. .. .. .. .. .. .. .a
.. .. .. .. .. .. .. .. a. #. #. #.
.. P. .. .. c. .. b. .. .. .. .. ..
.. P. P. .. .. .. .. .. .. .. .. ..
.. .. .. .. .. .. .. .. .. .. .. ..
.. .. .. .. .. .. .. .. .. .. .. ..
