.. #. .. .. #. ..
P. a. b. .a #. ..
.. .. c. d. #. ..
.. .. .. .. .. ..
.. .. .. .. .. ..
.. .. .. .. .. ..
