.. .. .. .. .. .. .. .. .. #. #. #.
#. #. #. .. .. .. .. .. .. #. #. #.
#. #. #. .. .. P. .. .. .. .. #. #.
#. .. .. .. .. b. .. .. .. .. .. #.
.. .. #. #. #. .. #. #. #. .. .. ..
.. .. #. #. #. .. #. #. #. .. .. ..
.. .. #. #. .. .. .. #. #. .. .. ..
#. .. .. .. .. #. .. .. .. .. .. ..
.. .. #. #. .. .. .. #. #. .. .. ..
.. .. #. #. #. .. #. #. #. .. .. ..
.. .. #. #. #. .. #. #. .b .. .. #.
#. .. .. .. .. .. .. .. .. .. #. #.
