.. P. .. .. .. .. .. .. .. .. .. ..
.. .. .. b. b. .. .. c. .. .. .. ..
.. .. .. .. b. .. .. c. c. .. .. ..
.. .. .. .. .. .. .. .. .. .. .. ..
.. .. .. .. .. .. .. #. #. #. #. ..
.. .. .. .. .. .. .. .. .b .b #. ..
.. .. .. .. .. a. .. .. .c .b #. ..
.. .. .. .. .. .. .. .. .c .c #. ..
.. .. .. .. .. .. .. #. #. #. #. ..
.. .. .. .. .. .. .. .. .. .. .. ..
.. .. .. .. .. .. .. .. .. .. .. ..
.. .. .. .. .. .. .. .. .. .. .. ..
