.. .. .. .. .. .. .. ..
.. a. .. .. .. .. .. ..
.. a. .. .. .. .. .. ..
.a .. .. .. P. .. .. ..
.a .. .. .. .. .. .. ..
.. .. .. .. .. .. b. b.
.. .. .. .. .. .. .b .b
.. .. .. .. .. .. .. ..
.. .. .. .. .. .. .. ..
