.. .. .. .. #. .. .. .. .. .. .. ..
.. .. .. .. #. .. .. .. .. .. .. ..
.b .b .. .. #. .. .. .. .. .. .. ..
.b .b .. .. #. .. .. .. a. .. .. ..
.. .. .. .. #. .. .. a. a. a. .. ..
.. .. .. .. #. .. .. .. a. .. .. ..
.. .. .. .. #. .. .. .. .. .. .. ..
.. .. .. .. #. b. b. .. .. .. .. ..
.. .. P. .. #. b. b. .. .. .. .. ..
.. .. .. .. .. .. .. .. .. .. .. ..
.. .. .. .. .. .. .. .. .. .. .. ..
.. .. .. .. .. .. .. .. .. .. .. ..
