#. .. .. .a #.
#. .. a. .. #.
#. .. .. .. #.
#. .. .. #. #.
#. .. e. .. #.
#. #. .. .. #.
#. .. d. .. #.
#. .. .. #. #.
#. .. c. .. #.
#. #. .. .. #.
#. .. b. .. #.
#. .. P. #. #.
