.. .. .. .. .. .. .. .. .. ..
.. .. .. a. a. .. .. .. .. ..
.. .. .. a. a. .. .. .. P. ..
.. .. .. .. .. .. .. .. .. ..
.. .. .. .. .. .. .. .. .. ..
.a .a .. .. .. .. .. .. .. ..
.a ba .. .. .. .. .. .. .. ..
