.. .. .. .. .. .. .. .. .. ..
.. .. .. a. .. .. .. .. .. ..
.. .. .. .. .. .. .. .. P. ..
.. .. .. .. .. .. .. .. .. ..
.. b. b. b. .. .. .. .. .. ..
.. .. .. .. .. .. .. .. .. ..
.. .a #. #. #. #. #. #. #. #.
