#. #. #. #. #. #. #. #. #. #. #. #.
#. #. #. .. #. .. #. .. #. .. #. #.
.. a. .. b. .. c. .. d. .. e. .. .a
.. .. .. .. .. .. .. .. .. .. .. ..
.. .. .. .. .. .. .. .. .. .. .. ..
.. .. f. .. .. .. .. .. .. .. .. ..
.. .. .. .. .. .. P. .. .. .. .. ..
.. .. .. .. .. .. .. .. .. g. .. ..
.. .. .. .. h. .. .. .. .. .. .. ..
.. .. .. .. .. .. .. .. .. .. .. ..
.. .. .. .. .. .. .. .. .. .. .. ..
.. .. .. .. .. .. .. .. .. .. .. ..
