.. .. .. .. .. .. .. .. .. .. .. .. .. .. .. .. .. .. .. .. ..
.. .. .. .. .. .. .. .. .. .. .. .. .. .. .. .. .. .. .. .. ..
.. .. .. .. .. .. .. .. .. .. .. .. .. .. .. .. .. .. .. .. ..
.. .. .. .. .. .. .. .. .. .. .. .. .. .. .. .. .. .. .. .. ..
.. .. .. .. .. .. .. .. .. .. .. .. .. .. .. .. .. .. .. .. ..
.. .. .. .. .. .. .. .. .. .. a. a. a. a. a. a. .. .. .. .. ..
.. .. .. .. .. .. .| .| .| .| a| .| .| .| .| a| .| .| .| .| .|
.. .. .. .. b. .. .| .. .. .. a. .. .. .. .. a. .. .. .. .. ..
.. .. .. .. .. .. .| .. .. .. .. .. .. .. .. a. .. .. .. .. ..
.. .. .. .. .. .. .| .. .. .. .. .. .. .. .. a. .. .. .. .. ..
.. .. .. .. .. .. .| .. .. .. a. a. a. a. a. a. .. .. .. .. ..
.. .. .. .. .. .. .| .. .. .. a. .. .. .. .. .. .. .. .. .. ..
.. .. .. .. .. .. .| .. .. .. a. .. .. .. .. .. .. .. .. .. ..
.. .. .. .. .. .. .| .. .b .. a. .. .. .. .. a. .. .. .. .. ..
.. .. .. .. .. .. .| .. .. .. a. .. .. .. .. a. .. .. .. .. ..
.. .. .. .. .. .. .| .. .. .. a. a. a. a. a. a. .. .. .. .. ..
.. .. .. .. .. .. .| .. .. .. .. .. .. .. .. .. .. .. .. .. ..
.. .. .. .. .. .. .| .. .. .. .. .. .. .. .. .. .. c. .. .. ..
.. .. .. .. .. .. .| .. .. .. .. .. .. P. .. .. .. .. .. .. ..
.. .. .. .. .. .. .| .. .. .. .. .. .. .. .. .. .. .. .. .. ..
.. .. .. .. .. .. .| .. #. #. .. .. .. .. .. d. .. .. .. .. ..
.. .. .. .. .. .. .| .. #. #. .. .. .. .. .. .. .. .. .. .. ..
.. .. .. .. .. .. .| .. .. .. .. .. .. .. .. .. .. .. .. .. ..
.. .. .. .. .. .. .| .. .. .. .. .. .. .. .. .. .. .. .. .. ..
