.. .. .. .. .. .. .. .d
.. .. .. .. .. .. .. .d
.. a. .. .. .. .. .. ..
.. a. .. P. P. .. .. d.
.a .. .. P. P. .. .. d.
.a .. .. .. .. .. b. b.
.. .. .. .. .. .. .b .b
.. c. .. .. .. .. .. ..
.c #. .. .. .. .. .| .|
