#. #. .. .. .b #. #.
#. #. .. .b .b #. #.
#. #. .. a. a. #. #.
#. #. .. a. .. #. #.
#. #. .. .. .. #. #.
#. #. .. .. .. #. #.
#. #. .. .. .. #. #.
#. .. .. .. .. .. #.
#. .. .. P. .. .. #.
#. .. .. .. .. .. #.
#. #. .. .. .. #. #.
#. #. .. .. .. #. #.
#. #. .. .. .. #. #.
#. #. .. b. .. #. #.
#. #. b. b. .. #. #.
#. #. .a .a .. #. #.
#. #. .a .. .. #. #.
